1,1,1,1,0,0,1,1,1,1
1,0,0,0,0,0,4,5,5,1
1,0,2,0,0,0,0,5,6,1
0,0,0,0,0,0,0,5,5,0
0,0,0,0,0,0,5,0,0,0
1,0,0,0,0,0,0,0,0,1
1,0,7,0,0,0,0,0,0,1
1,1,1,1,0,0,1,1,1,1