1,1,1,1,0,0,1,1,1,1
1,0,0,0,0,0,4,7,7,1
1,0,2,0,0,0,0,7,6,1
0,0,0,0,0,0,0,7,7,0
0,0,0,0,0,0,5,0,0,0
1,0,0,0,0,0,0,0,0,1
1,0,7,0,0,0,0,0,0,1
1,1,1,1,0,0,1,1,1,1